393939393939393939393939393939391c1c1c040404040404040404040404040404040404040404040404041c1c1c1c1c1c1c1c1c1c1c1c1c1c1c1c1c1c393939000000000000000000000000000000000000000000000000000000000000000000000000000000000000000000000000000000000000000000000000000000
0c282828282829292829290c3939393904000000000000000000000000000004040000000000000000000000000000040c39393939393939393939393939390c282829282828292828282928282829280c2829280c28282828282828280c2828282828282828282828282828282828280c2829292929290c3939393939393939
0d212727272727272727272829290c3904000000000000000000000000000004040000000000000000000000000000040d07070739393939393939390707070d310d0808080b080808080b0808080d2f0d2425260d21212727272122230d272f203127272727272727213121272731300d2727272727272829290c3939393939
0d212727272727272727272f2727281304000000000000000000000000000004040000000000000000000000000000040d07070707393939393939070707070d200f0808081b080808081b0808080f2f0d3435360d21272727273132330d272f2c2d2e272c1d2e272c2d2e272c1d2e210d27272727272727272728290c393939
0d272727272727272727272f27273f1304000000000000000000000000000004040000000000000000000000000000040d07070707393939393939070707070d271f08080808080b0b08080808081f2f0d2727270d27270c27272722230d272f3c3d3e273c3d3e273c3d3e273c3d3e2f0d272727272727272727272728133939
06272727272727272727272f2727271304000000000000002100000000000004040000000021212100000000000000040d07070707393939393939070707070d271a09080808081b1b08080808091a2f0d2727270d27270d27272721330d272f2727272727272727272727272727271a0d272727272727272727272727131c1c
06272727272727272727272f27273f130400000000000021210000000000000404000000210000002100000000000004280707070739393939393907070707282727270909090909090909090927272f282828140d27270d27272721210d272f0505050505050505050505050505050506272727272727272727272727133939
06272727272727272727272f272727130400000000002100210000000000000404000000000000210000000000000004270707070808080808080808070707272727272727272727272727272727272f272727272814142828280c282828272f0202020202020202020202020202020206272727272727272727272727133939
06272727272727272727272f27273f1304000000000000002100000000000004040000000000210000000000000000040c07070707393939393939070707070c27272c271d272e27272c271d272e272f272727272727272727210d222327272f0303030303030303030303030303030306272727272727272727272727133939
06272727272727272727272f2727271304000000000021212121210000000004040000002121212121000000000000040d07070707393939393939070707070d27273c273d273e27273c273d273e272f272727272727272727270f323327272f2727272727272727272727272727271a0c272727272727272727272727133939
0d272727272727272727272f27273f1304000000000000000000000000000004040000000000000000000000000000040d07070707393939393939070707070d2727272727272727272727272727272f272727270c1a272727271f272727272f2c1d2e272c1d2e272c2d2e272c1d2e2f0d27272727272727272727270c133939
0d212727272727272727272f27270c1304000000000000000000000000000004040000000000000000000000000000040d07070707393939393939070707070d2727272727272727272727272727272f272722230d272727272721272727272f3c3d3e273c3d3e273c3d3e273c3d3e200d2727272727272727270c2928393939
0d212727272727272727270c2828283904000000000000000000000000000004040000000000000000000000000000040d07070717393939393939170707070d2727272c271d272e2c271d272e27272f272721330d272727272727272727272f272727272721313127272727272731300d2727272727270c2929283939393939
2828282828282929282929283939393904000000000000000000000000000004040000000000000000000000000000042817171739393939393939391717172828282928282829282828292828282928282829282828292828282928282829282828292828282928282829282828292828282929292929283939393939393939
3939393939393939393939393939393904000000000000000000000000000004040000000000000000000000000000043939393939393939393939393939393939393939393939393939393939393939393939393939393939393939393939393939393939393939393939393939393939393939393939393939393939393939
1c1c1c1c1c1c1c1c1c1c1c1c1c1c1c1c04040404040404040404040404040404040404040404040404040404040404043939393939393939393939393939391c1c1c1c1c1c1c1c1c1c1c1c1c1c1c1c1c1c1c1c1c1c1c1c1c1c1c1c1c1c1c1c1c1c1c1c1c1c1c1c1c1c1c1c1c1c1c1c1c1c1c1c1c1c1c1c1c1c1c1c1c1c1c1c1c
1339393939393939393939393939393939393939393939393939393939393939393939393939393939393939393939393939393939393939393939393939393900000000000000000000000000000000000000000000000000000000000000000000000000000000000000000000000000000000000000000000000000000000
0c39393939393939393939393939390c0c282928282829282828292828282928282829280c282928280c292828282928282829282828292828282928282829280c282928282829280c28292828282928280c292828282928282829282828290c28280c2828282928282829282828292828282928282829282828292828282928
0d07070739393939393939390707070d0d212223272121213131313131212727272731210d080b08080d2121272727271a271a27271a2d271c21211a27271a270d212121212131210d2c2d2e272c2d2e270d0b08272727273d1d272727272e0d21270d2121312727272727313127272727272721212727212127272121272727
0d07070707393939393939070707070d0d213233212131273121212721312721272727270f081b08080f272727272727272727273d271d2727272727272727270d2131316d2121210d3c3d3e273c3d3e270d1b0808272727272d272727273e0d31270d2127271a1a272727272727272727272e0c28282928282928280c2c2727
0d07070707040404040404070707070d0d2131303127272727273127273121272727271a1f090909091f1a2727272727272727272727190a0a0a0a0a1c27272728282828142828280d27272727272727270d0808272727273d1d27272727210d31270d2727271a1a271a27272727272727273e0d3127276d276d3131283c2727
0d070707071c1c1c1c1c1c070707070d0d263621272727272727272727273127272727272727272727272727272727272727272727272727272727272727272727272727272727270d27272727272727272828280c27270c28280c281414282827270d271a271a1a6d1a27270e2727272727270d272727272727272727272727
0d0707070739393939393907070707280d262027272727272727272727312121272c2d2e272727276d272c1d2e27272727272c2d2e27273d2727273d2727272727272727272727270d27272727272d27272727270d27270d27270d1a2727272727270d271a271a1a1a1a27270d27272727273d0d27272727276d27270c272727
060707070704042727040407070707270d242527272716272727272727272127273c3d3e2727272727273c3d3e27272727273c3d3e2727276d276d2727272727272c2d2e272c2d2e0f2c2d2e27272d27272727272814142827270d272727272727270d271a1a1a1a1d6d27270d27272727272728272c272a2b272e270d3d2727
0c07070707393917173939070707070c0d3435272727272727272727272731272727272727276d27272727272727272727272727272727272727272c2d2e2727273c3d3e273c3d3e1f3c3d3e27272d27270e27271a27271a27270d302624252727270d27271d1a1a2d2727270d27272727272727273c273a3b273e270d272727
0d07070707393939393939070707070d0d3026312727272727272727312721312727272727272727272727272727272727272727272727272727273c3d3e2727272727272727272727272727276d3d27270d27272727272727270d263634352727270f2727190a0a152727270d27272727272e0c27272727272727270d2c2727
0d07070707040404040404070707070d0d2030212727272727272727272121272727272c2d2e27272c2d2e2727272727273d27273d27273d272727272727272727272727272727272727272727272727270d2727276d276d27270d1a2727272727271f27273d3d3d3d2727210d21272727273e0d27272727272727270d3c2727
0d07070707393939393939070707070d0d3620202024252627222321213127272727273c3d3e27273c3d3e2727272727210a0a0a0a0a0a0a0a0a272727272727272c2d2e272c2d2e270a0a0a0a0a0a0a270d31272727272727300d2c272727272727272727272727272727210d21272727272728282829282829282828272727
0d07070717393939393939170707070d0d3636202634353636323321212626272727272727272727272727272727272721272727272727272721272727272727273c3d3e273c3d3e2721272721272721270d26212127272731200d3c272727272727272727272727272727210d21272727272721212727212127272121272727
2817171739393939393939391717172828282928282829282828292828282928282829282828292828282928282829282828292828282928282829282828292828282928282829282828292828282928282829282828292828282928282829282828292828282928282829282828292828282928282829282828292828282928
3939393939393939393939393939393939393939393939393939393939393939393939393939393939393939393939393939393939393939393939393939393939393939393939393939393939393939393939393939393939393939393939393939393939393939393939393939393939393939393939393939393939393939
1c1c1c1c1c1c1c1c1c1c1c1c1c1c1c1c1c1c1c1c1c1c1c1c1c1c1c1c1c1c1c1c1c1c1c1c1c1c1c1c1c1c1c1c1c1c1c1c1c1c1c1c1c1c1c1c1c1c1c1c1c1c1c1c1c1c1c1c1c1c1c1c1c1c1c1c1c1c1c1c1c1c1c1c1c1c1c1c1c1c1c1c1c1c1c1c1c1c1c1c1c1c1c1c1c1c1c1c1c1c1c1c1c1c1c1c1c1c1c1c1c1c1c1c1c1c1c1c
9393939393939393939393939393939393939393939393939393939393939393939393939393939393939393939393939393939393939393939393939393939393939393939393939393939393939393939393939393939393939393939393939393939393939393939393939393939393939393939393939393939393939393
8282928282829282828292828282928282829282828292828282928282829282c0829282c0829282c0829282c082c08282c082929292929292929282c082928282c09282c09282c09282c09282c092828282c09292c0c0c09292c08282c0928282829282828292828282928282829282c082928282829282828292828282c082
02137272721302727212a172727272a172122290909090909090905272121212d0c1a0a0d0a0a0c1d0a0a0c1d0c3d02232d060c1c1c1c1c1c1c1c160d012127213d0c3c1d0c3c1d0c3c1d0c3c1d0121272e2d01212d0d0d01212d04040d0126363425262727272721272727272727272d0a0a0c1a0a0a0a0a0a0a0c1a0a0d072
1272727272727272727272727272727272132390909090909090905372020202d0727213d0727272d0727213d061d02333d0f28183838383838381f2d012727213d07272d07272d07272d07372d0127272e3d072728282827272d0828282127262435363425262631312727272121372d0d37272d37272d37272d37272d3d072
727272d2d2727272e0727272d2d2727272727290909090909090907272720202d072f3d3d072f3d3d0d3f372d072d07272d0f28183838383838381f2d012727272d04182824182824182824182d012727272d07272a112a17272d072727272727272425243537272d613425213127272d022327272727272727272727213d072
7272d3d1d2d37272d07272d3d2d1d37272727272727272d672d6727272727202d0727272d0824182d0727272d073d07272d0f28183838383838381f2d012727272d07272727272727272d672d6d0727272e2d072727272727272d07272c0c27272724353727272727272435312727272d023337272727272727272d60212d072
727272d2d1727272d0727272d2d27272727272727272727272727272727272728282418282a172a1828241828241827272d090909090909090909090d072727272d07272727272727272727272d0727272e3d082929292928241d07272d0c3727272121372727272727263727272727282828282828272727282828282828272
7272d3d2d2d37272f07272d3d1d2d372727272c1a0a0a0a0a0a0c172727272727272727272727272727272727272727272d0a1a1727272727272f3d1d072727272d0a17272727272727272d6a1d072727272d07272727272d672d07272d07272727213727272727272726272727272727272727272a1727272a1727272727272
7272729151727272f1727272915172727272d3d17272727272a1d272727272727272727272727272d67272727272727272d0a1a1a1727272727272d3d07272727282828282828241418282828282727272728272727272727272827272d0c2121342527272425272726362627272727272727272727272727272727272727272
727272727272727272727272d6727272727272d2727272727272d1d37272727272727272c0824182c0824182c041c0727282828282828282414182828272727272a112121272727272727272127272727272727272c092c07272727272d0c3137243534252435312124252121213727272727272727272727272727272727272
7272727272727272727272727272727272727291a0a0a0a0c1a051727272727272727202d0727291d0727272d012d002727272a1121222327272223272727272727272727272727272727272727272727272c07272d040d07272c08282d0727272726343537272721343537272121372c082828282c0727272c082828282c072
721372727272c272d172e272d672727272727272d37272d372d372727272727272720312d04272f3d0f3a0f3d012d012727272727272233372722333727272727272727272727212727272727272727272e2d07272d040d07272d0a2b2d0c27272727212137272727262637272727272d022320213827272728213034252d072
121213021272c372d372e372727272a11272727272727272727272727272727272721362d0437212d072f312d013d01272727272727272727272727272727272727272727272121213a172727272727272e3d07272d040d07272d0a3b3d0c37272727212727272727272137272727272d023331372417272724172134353d072
8282928282829282828292828282928282829282828292828282928282829282828292828282928282829282828292828282928282829282828292828282928282829282828292828282928282829282828282828282928282828282828292828282928282829282828292828282928282829282828292828282928282829282
9393939393939393939393939393939393939393939393939393939393939393939393939393939393939393939393939393939393939393939393939393939393939393939393939393939393939393939393939393939393939393939393939393939393939393939393939393939393939393939393939393939393939393
c1c1c1c1c1c1c1c1c1c1c1c1c1c1c1c1c1c1c1c1c1c1c1c1c1c1c1c1c1c1c1c1c1c1c1c1c1c1c1c1c1c1c1c1c1c1c1c1c1c1c1c1c1c1c1c1c1c1c1c1c1c1c1c1c1c1c1c1c1c1c1c1c1c1c1c1c1c1c1c1c1c1c1c1c1c1c1c1c1c1c1c1c1c1c1c1c1c1c1c1c1c1c1c1c1c1c1c1c1c1c1c1c1c1c1c1c1c1c1c1c1c1c1c1c1c1c1c1
9393939393939393939393939393939393939393939393939393939393939393939393939393939393939393939393939393939393939393939393939393939393939393939393939393939393939393939393939393939393939393939393939393939393939393939393939393939393939393939393939393939393939393
8282928282c09282828292828282928282829282828292828282928282829282c08292828282928282829282c0829282828292828282928282829282828292828282829282828292828282928282829282c0829282c08282828282828282c08282828282828282828282828282828282c082828282829292829292c093939393
a1727272a1d0a1727272d2727213131372e2c272d1c272c1c172e2d172e2c272d0c2727272727272727272e2d0420372c1c1a2b2c1c1c1a2b2c1c1c1a2b2c1c17213d0808080b080808080b0808080d072d0425262d01212727272122232d07272021372727213137272121312721213d012727272727272727272829292c093
c2d272d1e2d07272727291a0a0a0c1c172e3c372d3c372727272e3d372e3c372d0c3727272425272727272e3d04372727270a3b370a170a3b370a170a3b37072c002f0808080b180808080b1808080f072d0435363d012d672d672132333d07272c2d272c2d272c2d272c2d272c2d213d012727272727272727272f2727282c1
c3d372d3e3d07272727272727272727272727272727272727272727272727272d0a1727272435363127272a1d002727272707070707270707070727070707072d072f18080808080b0b08080808080f172d0727272d07272c07272722232d07272c3d372c3d372c3d372c3d372c3d372d072727272727272727272f27272f331
7272727272d0137213e0c2d172d2e2727272727272a172727272a17272727272828241828282c082828241828272727272f27272f272f27272f272f27272f272d072a19080808080b1b18080808090a172d0727272d07272d0d672721233d07272727272727272727272727272d672726072727272721272727272f272727231
72c2d1e272d02232a1d0c3d372d3e37272637272d3d2f37272f3d1d372726272727272722232d002020372727272727272f27272f213f27272f202f27272f272827272729090909090909090909072727282828241d07272d07272721212d072505050505050505050505050505050506072727272721272727272f27272f331
72c3d3e372d0233313d0a172727272727262727272d1f3d672f3d27272726272727272722333d012037272727272727272f27272f213f27272f213f27272f272727272727272d672d672d672727272727272727272824141828282c082828272010101010101010101010101010101016072727272721272727272f272727231
7272727272f07212d6d0c272d172727272637272d3d2d6f3f3d6d2d372726372c08241828282d08282824182c072727272f27272f212f27272f202f27272f272c07272c272d172e27272c272d172e2727272727272727272727212d022327272303030303030303030303030303030306072727272721272727272f27272f331
7272727272f1727272d0c372d3727272727272727291a0a0a0a0517272727272d07272720262f0a172727272d072727272f27272f272f27272f272f27272f272d07272c372d372e37272c372d372e3727272727272727272727272f02333727272727272727272727272727272d672726072727272721272727272f272727231
727272727272727272d0a1727272727272727272727272727272727272727272d00372727272f17272727212d0a1727272c17272c1c1c17272c1c1c17272c172d07272727272727272727272727272727272727272c0a172727272f17272727272c2d272c2d272c2d272c2d272c2d272d072727272727272727272f27272f331
223272727272727272d0c2d272d1e27272e2c272d1c272727272e2d172e2c272d04202727272727272d60363d0223272e270f3f3e270c2f3f3e270c2f3f370c2827272727272727272727272727272727272722232d07272727272127272727272c3d372c3d372c3d372c3d372c3d313d012727272727272727272f27272c093
23331312a1727272a1d0c3d372d3e37272e3c372d3c372c1c172e3d372e3c372d043620372727272d6031362d0233372e37013f3e370c3f3f3e370c3f31270c372727272c272d172e2c272d172e272727272721233d07272727272727272727272721272727212131372727272727213d012727272727272727272c082828293
8282928282829282828292828282928282829282828292828282928282828282828292828282928282829282828292828282928282829282828292828282928282828292828282928282829282828292828282928282829282828292828282928282829282828292828282928282829282828282828292928292928293939393
9393939393939393939393939393939393939393939393939393939393939393939393939393939393939393939393939393939393939393939393939393939393939393939393939393939393939393939393939393939393939393939393939393939393939393939393939393939393939393939393939393939393939393
c1c1c1c1c1c1c1c1c1c1c1c1c1c1c1c1c1c1c1c1c1c1c1c1c1c1c1c1c1c1c1c1c1c1c1c1c1c1c1c1c1c1c1c1c1c1c1c1c1c1c1c1c1c1c1c1c1c1c1c1c1c1c1c1c1c1c1c1c1c1c1c1c1c1c1c1c1c1c1c1c1c1c1c1c1c1c1c1c1c1c1c1c1c1c1c1c1c1c1c1c1c1c1c1c1c1c1c1c1c1c1c1c1c1c1c1c1c1c1c1c1c1c1c1c1c1c1c1
